1 1 1 1 1 1 1 1 1 1 1 1 1 1 1 1 1 1 1 1 1 1 1 1 1 1 1 1 1 1 1 1 1 1 1 1 
4 0 0 0 0 0 0 0 0 0 0 0 1 1 1 1 1 1 0 0 0 0 0 0 0 8 1 0 0 0 0 0 0 0 0 1
1 0 1 1 1 1 1 1 1 1 1 0 0 0 0 0 0 1 0 1 1 1 1 1 0 1 1 0 1 1 0 1 1 1 0 1
1 0 1 5 0 0 0 0 0 0 7 1 1 1 1 1 0 1 0 1 0 0 0 1 0 7 1 0 0 0 0 0 0 1 0 1
1 0 1 1 1 1 0 1 1 1 1 0 0 1 8 1 0 0 0 0 0 1 0 1 1 1 1 0 1 1 1 1 0 1 0 1
1 0 0 0 0 0 0 0 0 1 0 8 1 1 0 1 0 1 1 1 1 1 0 0 0 0 0 0 8 1 5 0 0 1 0 1
1 0 1 1 1 1 1 1 0 0 0 1 0 0 0 0 0 0 0 0 0 1 1 1 1 1 1 1 1 1 1 1 1 1 0 1
1 0 0 0 1 0 0 8 1 1 0 0 0 1 1 1 1 0 1 1 0 0 1 0 0 0 1 0 0 0 0 0 0 0 0 1
1 1 1 0 0 0 1 1 1 8 1 1 1 0 0 0 1 0 0 0 1 0 1 7 1 0 0 0 1 1 1 1 1 1 1 1
1 1 1 1 0 1 1 1 1 0 0 0 0 0 1 0 1 1 1 1 5 0 1 1 1 0 1 0 1 5 7 0 0 0 0 1
1 0 0 0 0 0 0 0 0 0 1 1 1 1 1 0 0 0 0 8 1 1 7 0 1 0 1 0 1 1 1 1 1 1 0 1
1 0 1 1 1 1 1 1 1 1 1 0 0 0 0 1 1 0 1 1 1 1 1 0 0 0 1 0 0 0 0 0 0 0 0 1
1 0 0 0 0 0 0 0 0 0 1 0 1 1 0 0 0 0 1 1 8 0 0 0 1 0 1 0 1 0 1 1 1 1 1 1
1 0 1 1 0 1 1 1 1 0 0 0 0 0 0 1 1 0 1 1 1 1 1 1 1 0 0 0 1 0 0 0 0 1 8 1
1 0 1 8 0 0 0 0 0 1 1 1 0 1 0 0 0 0 1 8 1 8 1 8 1 1 0 1 1 1 0 1 0 0 0 1
1 0 1 1 1 1 1 1 0 0 0 0 0 0 0 1 1 0 0 0 0 0 0 0 0 1 0 1 1 1 0 1 1 1 1 1
1 0 0 0 0 1 0 5 1 1 1 1 0 1 1 1 8 1 1 1 1 1 1 1 1 1 0 0 0 0 0 0 0 0 0 1
1 1 1 1 0 0 0 1 0 0 0 0 0 0 0 0 0 0 0 0 0 0 5 1 1 1 1 1 1 1 1 1 1 7 2 1
1 1 1 1 1 1 1 1 1 1 1 1 1 1 1 1 1 1 1 1 1 1 1 1 1 1 1 1 1 1 1 1 1 1 1 1
