----------------------------------------------------------------
----------------------------------------------------------------
----------------------------------------------------------------
----------------------------------------------------------------
----------------------------------------------------------------
----------------------------------------------------------------
----------------------------------------------------------------
----------------------------------------------------------------
----------------------------------------------------------------
----------------------------------------------------------------
----------------------------------------------------------------
----------------------------------------------------------------
----------------------------------------------------------------
----------------------------------------------------------------
----------------------------------------------------------------
----------------------------------------------------------------
----------------------------------------------------------------
---1--7---------1--------------------------1--7---------1-------
---11111111111111--------------------------11111111111111-------
---1------------1--------------------------1------------1-------
---1---1-1-1-1-1---------------------------1------------1-------
---1---------------------------------------1------------1-------
---1------------9--------------------------13-----------1-------
---1--1-1-1-1-1-1--------------------------11111111111--1-------
---1------------1--------------------------1------8-----1-------
---1------8-----1--------------------------1------------1-------
---16---------231--------------------------19----------61-------
---11111111111111--------------------------11111111111111-------
----------------------------------------------------------------
----------------------------------------------------------------
----------------------------------------------------------------
----------------------------------------------------------------
----------------------------------------------------------------
----------------------------------------------------------------
----------------------------------------------------------------
----------------------------------------------------------------

TL - start
TL 15, 26 - [55, 26]
TL 44, 22 - [4, 26]
TL - end
