------------------------1111111111-------1----------------------
------------------------179--3-----11111--1--1-1-1-1-1-151-1-1--
------------------------11111111111--------1------------5----1--
--------------------------------------------------------5-116---
--------------------------------------------------------51------
-----------------------------------------------------1111-------
-------------------------------------------------111------------
----------------------------------------------------------------
---------------------------------------------111----------------
----------------------------------------------------------------
------------------------------------------11--------------------
---------------------------------------1------------------------
----------------------------------------------------------------
----------------------------------------1-----------------------
-------------------------------------------11-------------------
-----------------------------------------------11---------------
---------------------------------------------------111----------
-------------------------------------------------------1111-----
---------------------------------------------------------------1
-------------------------------------------------------------1--
-----------------------------------------------------------1----
---------------------------------------------------------1------
-----------------------------------------------------5----------
----------------------------------------------------111---------
1-------------------------------------------------1-------------
1---------------------------------------------------------------
1-----------------------------------------------1---------------
13--------------------------------------------1-----------------
11111-----4-----------------------------------------------------
--------11111------------------------------1--------------------
----------------111---------------------------------------------
--111----------------111-----88----------1----------------------
--196-------------------1-------------1-------------------------
--111111------------------1111111111111-------------------------
----------------------------------------------------------------
----------------------------------------------------------------

TL - start
TL 1, 27 - [60, 3]
TL 29, 1 - [4, 32]
TL - end
